70,70
WWWwwWWWWWWWWWWWWWWWWWWWWWWWWWWWWWWWWWWWWWWWWWWWWWWWWWWWWWWWWWWwwWWWWW
WWWwwWWWWWWWWWWWWWWWWWWWWWWWWWWWWWWWWWWWWWWWWWWWWWWWWWWWWWWWWWWwwWWWWw
WWWwwWWWWWWWWWWWWWWWWWWWWWWWWWWWWWWWWWWWWWWWWWWWWWWWWWWWWWWWWWWwwWWWWw
WWWwwWWWWWWWWWWWWWWWWWWWWWWWWWWWWWWWWWWWWWWWWWWWWWWWWWWWWWWWWWWwwWWWWw
WWWwwWWWWWWWWWWWWWWWWWWWWWWWWWWWWWWWWWWWWWWWWWWWWWWWWWWWWWWWWWWwwWWWWw
WWWwwWWWWWWWWWWWWWWWWWWWWWWWWWWWWWWWWWWWWWWWWWWWWWWWWWWWWWWWWWWwwWWWWw
WWWwwWWWWWWWWWWWWWWWWWWWWWWWWWWWWWWWWWWWWWWWWWWWWWWWWWWWWWWWWWWwwWWWWw
WWWwwWWWWWWWWWWWWWWWWWWWWWWWWWMWMWWWWWWWWWWWWWWWWWWWWWWWWWWWWWWwwWWWWw
WWWwwWWWWWWWWWWWGWGWGGGGGWWWMMMMMMMWWWWWWWWWGGGGGGGWGWWWWWWWWWWwwWWWWw
WWWwwWWWWWWWWWGGGGGGGGGGGGGMMMMMMMMMMGGGRRGGGGGGGGGGGGGGGWWWWWWwwWWWWw
WWWwwWWWWWWWWGGGGGGGGGGGGGGGGGGGGGGMMMRRRRGGGGGGGGGGGGGGMWWWWWWwwWWWWw
WWWwwWWWWWWWWGGGGGGGGGGGGGGGGGGGGGGMGMRRGGGGGGGGGGGGGGMMMWWWWWWwwWWWWw
WWWwwWWWWWWWWGGGGGGGGGGGGGGGGGGGGGGGRRRGGGGGGGGGGGGGGGMMMWWWWWWwwWWWWw
WWWwwWWWWWWGGGGGGGGGGGGGGGGGGGMMGGGGRRGGGGGGGGGGGGGGGMMMMWWWWWWwwWWWWw
WWWwwWWWWWWWWGGGGGGGGGGGGGGGMMMMGGRRRRGGGGGGGGGGGGGGMMMMWWWWWWWwwWWWWw
WWWwwWWWWWWWWGGGGGGGGGGGGGMMMMMMRRRRRRGGGGGGGGGGGGGGMMMMGWWWWWWwwWWWWw
WWWwwWWWWWWWGGGGGGGGGGGGGMMMMMGRRRRRGGGGGGGGGGGGGGGGMMMMGGWWWWWwwWWWWw
WWWwwWWWWWWWGGGGGGGGGGGGMMMMGGRRRRGGMGGGGGGGGGGGGGGMMMMGGGWWWWWwwWWWWw
WWWwwWWWWWWWWGGGGGGGGGMMMMGGRRRRGGGGMMGGGGGGGGGGGGGMMMGGGGWWWWWwwWWWWw
WWWwwWWWWWWWWGGGGGGGMMMMGGRRRRRRGGGGMMMGGGGGGGGGGGMMGGGGGGWWWWWwwWWWWw
WWWwwWWWWWWWMMMMMMMMMMMMRRRRRRRRGGGGMMMMGGGGGGGGGGMMGGGGGWWWWWWwwWWWWw
WWWwwWWWWWWWMMMMMMMMGGRRRRRRRRGGGGGGMMMMGGGGGGGGMMGGGGGGGWWWWWWwwWWWWw
WWWwwWWWWWWWWWGGGMGMGGRRRRRRGGGGGGGGMMMMGGGGGGGGGGGGGGGGWWWWWWWwwWWWWw
WWWwwWWWWWWWWWGGGGGGRRRRRRRRGGGGGGGGMMMGGGGGGGGGGGGGGGGWWWWWWWWwwWWWWw
WWWwwWWWWWWWWWGGGGRRRRRRMMMMGGGGGGGGMMMGGGGGGGGGGGGGGGGWWWWWWWWwwWWWWw
WWWwwWWWWWWWWWGGRRRRRRGGMMMMMGGGGGGGMMMGGGGGGGGGGGGGGGGWWWWWWWWwwWWWWw
WWWwwWWWWWWWWWRRRRRRGGGGGMMMMMMGGGGMMMGGGGGGGGGGGGMGGGGWWWWWWWWwwWWWWw
WWWwwWWWWWWWWRRRGGGGGGGGGMMMMMMMMGGMMMGGGGGGGGGGGMMGGGGGWWWWWWWwwWWWWw
WWWwwWWWWWWWWWGGGGGGGGGGGGGMMMMMMMMMMMGGGGGGGGGGGMMMGGGGGWWWWWWwwWWWWw
WWWwwWWWWWWWWWGGGGGGGGGGGGGGGMGMMMMMMMGGGGGGGGGGGMMMMGGGGWWWWWWwwWWWWw
WWWwwWWWWWWWWWGGGGGGGGGGGGGGGGGGGMMMMGGGGGGGGGGGGMMMMGGGGWWWWWWwwWWWWw
WWWwwWWWWWWWWWGGGGGGGGGGGGGGGGGGGMMMGGGGGGGGGGGGGGMMMMMGGWWWWWWwwWWWWw
WWWwwWWWWWWWWWGGGGGGGGGGGGGGGGGGGMMGGGGGGGGGGGGGGGGMMMMMGWWWWWWwwWWWWw
WWWwwWWWWWWWWWGGGGGGGGGGGGGGGGGGMMGGGGGGGGGGGGGGGGGGGMMMMWWWWWWwwWWWWw
WWWwwWWWWWWWWWGGGGGGGGGGGGGGGGGMMMGGGGGGGGGGGGGGGGWGWWWMMMWWWWWwwWWWWw
WWWwwWWWWWWWWWGGGGGGGGWGWWWWWWWMWWWWWWWWWWWGWWWWWWWWWWWWWWWWWWWwwWWWWw
WWWwwWWWWWWWWWGGGGGGWWWWWWWWWWWWWWWWWWWWWWWWWWWWWWWWWWWWWWWWWWWwwWWWWw
WWWwwWWWWWWWWWGGGGWWWWWWWWWWWWWWWWWWWWWWWWWWWWWWWWWWWWWWWWWWWWWwwWWWWw
WWWwwWWWWWWWWGGGWWWWWWWWWWWWWWWWWWWWWWWWWWWWWWWWWWWWWWWWWWWWWWWwwWWWWw
WWWwwWWWWWWWWWWWWWWWWWWWWWWWWWWWWWWWWWWWWWWWWWWWWWWWWWWWWWWWWWWwwWWWWw
WWWwwWWWWWWWWWWWWWWWWWWWWWWWWWWWWWWWWWWWWWWWWWWWWWWWWWWWWWWWWWWwwWWWWw
WWWwwWWWWWWWWWWWWWWWWWWWWWWWWWWWWWWWWWWWWWWWWWWWWWWWWWWWWWWWWWWwwWWWWw
WWWwwWWWWWWWWWWWWWWWWWWWWWWWWWWWWWWWWWWWWWWWWWWWWWWWWWWWWWWWWWwwWWWWWw
WWWwwWWWWWWWWWWWWWGWWWWWWWWWWWWWWWWWWWWWWWWWWWWWWWWWWWWWWWWWWWwwWWWWWw
WWWwwWWWWWWWWWGWGGGGGWGWGWWGMGMMMWMMMWMWMWMWMWMWMWMWWWWWWWWWWWwwWWWWWw
WWWwwWWWWWWWWWGGGGGGGGGGGGGMMMDMMMDMMMMMMMMMMMMMMMMMMMMMWWWWWWwwWWWWWw
WWWwwWWWWWWWWGGGGGGGGGGGGGGMMMMMMMDDDDDDDMMMDMDMDMDMDDDMMWWWWWwwWWWWWw
WWWwwWWWWWWWWWGGGGGGGGGGMMMMMMMMMMDDDDDDDDDDDDDDDDDDDDDMMWWWWWWwWWWWWw
WWWwwWWWWWWWWWGGGGGGGGGGMMMMMMMMMMDDDDMDDDDDDDDDDDDDDDDMMWWWWWWwWWWWWw
WWWwwWWWWWWWWWGGGGGGMMMDDMMMMMDDDMDDDDMMDDDDDDDDDDDDDDMMMWWWWWWwwWWWWw
WWWwwWWWWWWWWWGGGGMGMMMDDMMMMMDDDDDDDDDMDDDDDDMDDDDDDDMMMWWWWWWwwWWWWw
WWWwwWWWWWWWWWGGMMMMMMMMMDDMMMDDDDDDDDDDDDDDDDMMDDDDDMMMWWWWWWWwwWWWWw
WWWwwWWWWWWWWWMMMMMMMMMMMDDMMMMMMDDDDDDDDDDDDDMMDDDDDDMMWWWWWWWwwWWWWw
WWWwwWWWWWWWWWMMMMMMMMMMMDDDMMDMMMMDMDDDDDDDDDDDDDDDDDMMWWWWWWWwwWWWWw
WWWwwWWWWWWWWMMMMMMMMMMMMMDDDMMMMMMMMMDDDDDDDDDDDDDDDDMMWWWWWWWwWWWWWw
WWWwwWWWWWWWWMMMMMMMMMMMMMMDDDDMMMDDDDDDDDDDDDDDDDDDDDMMWWWWWWWwwWWWWw
WWWwwWWWWWWWWWMMMMMMDMDDMMMMMDDDDDDDDDDDDDMDDDDDDDDDDDMMWWWWWWWwwWWWWw
WWWwwWWWWWWWWWMMMMMMMMMMDDDMDMMMMDDDDDDDDDMMDDDDDDDDDDDMWWWWWWWwwWWWWw
WWWwwWWWWWWWMMMMMMMMMMDDDDDDDDDDDDDDDDDDDDDDDDDDDDDDDDMMWWWWWWWwwWWWWw
WWWwwWWWWWWWWMMMMMMMMDMDDDDDDDDDDDDDDDDDDDDDDDDDDDDDDDMMWWWWWWWwwWWWWw
WWWwwWWWWWWWWWWDWMWMWMMMMDMMMDMMMMMMMMMMMMMMMMMMMMMMMMWWWWWWWWwwWWWWWw
WWWwwWWWWWWWWWWWWWWWWWWMMMWMWMWMWMWMMMWWWMWMMMMMMMMMWWWWWWWWWWwwWWWWWw
WWWwwWWWWWWWWWWWWWWWWWWWWWWWWWWWWWWWWWWWWWWWWWWWWWWWWWWWWWWWWWWwWWWWWw
WWWwwWWWWWWWWWWWWWWWWWWWWWWWWWWWWWWWWWWWWWWWWWWWWWWWWWWWWWWWWWWwWWWWWw
WWWwwWWWWWWWWWWWWWWWWWWWWWWWWWWWWWWWWWWWWWWWWWWWWWWWWWWWWWWWWWWwwWWWWw
WWWwwWWWWWWWWWWWWWWWWWWWWWWWWWWWWWWWWWWWWWWWWWWWWWWWWWWWWWWWWWWwwWWWWw
WWWwwWWWWWWWWWWWWWWWWWWWWWWWWWWWWWWWWWWWWWWWWWWWWWWWWWWWWWWWWWWwwWWWWw
WWWwwWWWWWWWWWWWWWWWWWWWWWWWWWWWWWWWWWWWWWWWWWWWWWWWWWWWWWWWWWWwwWWWWw
WWWwwWWWWWWWWWWWWWWWWWWWWWWWWWWWWWWWWWWWWWWWWWWWWWWWWWWWWWWWWWWwwWWWWw
WWWwwWWWWWWWWWWWWWWWWWWWWWWWWWWWWWWWWWWWWWWWWWWWWWWWWWWWWWWWWWWwwWWWWw