60,60
WWWWWWWWWWWWWWWWWWWWWWWWWWWWWWWWWWWWWWWWWWWWWWWWWWWWWWWWWWWW
WWWWWWWWWWWWWWWWWWWWWWWWWMWMWWWWWWWWWWWWWWWWWWWWWWWWWWWWWWWW
WWWWWWWWWWWGWGWGGGGGWWWMMMMMMMWWWWWWWWWGGGGGGGWGWWWWWWWWWWWW
WWWWWWWWWGGGGGGGGGGGGGMMMMMMMMMMGGGRRGGGGGGGGGGGGGGGWWWWWWWW
WWWWWWWWGGGGGGGGGGGGGGGGGGGGGGMMMRRRRGGGGGGGGGGGGGGMWWWWWWWW
WWWWWWWWGGGGGGGGGGGGGGGGGGGGGGMGMRRGGGGGGGGGGGGGGMMMWWWWWWWW
WWWWWWWWGGGGGGGGGGGGGGGGGGGGGGGRRRGGGGGGGGGGGGGGGMMMWWWWWWWW
WWWWWWWWGGGGGGGGGGGGGGGGGMMGGGGRRGGGGGGGGGGGGGGGMMMMWWWWWWWW
WWWWWWWWGGGGGGGGGGGGGGGMMMMGGRRGGGGGGGGGGGGGGGGMMMMWWWWWWWWW
WWWWWWWWGGGGGGGGGGGGGMMMMMMRRGGGGGGGGGGGGGGGGGGMMMMGWWWWWWWW
WWWWWWWWGGGGGGGGGGGGMMMMMGRRRGGGGGGGGGGGGGGGGGGMMMMGGWWWWWWW
WWWWWWWWGGGGGGGGGGGMMMMGGRRGGGGMGGGGGGGGGGGGGGMMMMGGGWWWWWWW
WWWWWWWWGGGGGGGGGMMMMGGRRRRGGGGMMGGGGGGGGGGGGGMMMGGGGWWWWWWW
WWWWWWWWGGGGGGGMMMMGGGGRRGGGGGGMMMGGGGGGGGGGGMMGGGGGGWWWWWWW
WWWWWWWMMMMMMMMMMMMGGRRGGGGGGGGMMMMGGGGGGGGGGMMGGGGGWWWWWWWW
WWWWWWWMMMMMMMMGGGGRRRRGGGGGGGGMMMMGGGGGGGGMMGGGGGGGWWWWWWWW
WWWWWWWWWGGGMGMGGRRRRGGGGGGGGGGMMMMGGGGGGGGGGGGGGGGWWWWWWWWW
WWWWWWWWWGGGGGGRRRRGGGGGGGGGGGGMMMGGGGGGGGGGGGGGGGWWWWWWWWWW
WWWWWWWWWGGGGRRRRGGMMMMGGGGGGGGMMMGGGGGGGGGGGGGGGGWWWWWWWWWW
WWWWWWWWWGGRRRRGGGGMMMMMGGGGGGGMMMGGGGGGGGGGGGGGGGWWWWWWWWWW
WWWWWWWWWRRRRGGGGGGGMMMMMMGGGGMMMGGGGGGGGGGGGMGGGGWWWWWWWWWW
WWWWWWWWRRRGGGGGGGGGMMMMMMMMGGMMMGGGGGGGGGGGMMGGGGGWWWWWWWWW
WWWWWWWWWGGGGGGGGGGGGGMMMMMMMMMMMGGGGGGGGGGGMMMGGGGGWWWWWWWW
WWWWWWWWWGGGGGGGGGGGGGGGMGMMMMMMMGGGGGGGGGGGMMMMGGGGWWWWWWWW
WWWWWWWWWGGGGGGGGGGGGGGGGGGGMMMMGGGGGGGGGGGGMMMMGGGGWWWWWWWW
WWWWWWWWWGGGGGGGGGGGGGGGGGGGMMMGGGGGGGGGGGGGGMMMMMGGWWWWWWWW
WWWWWWWWWGGGGGGGGGGGGGGGGGGGMMGGGGGGGGGGGGGGGGMMMMMGWWWWWWWW
WWWWWWWWWGGGGGGGGGGGGGGGGGGMMGGGGGGGGGGGGGGGGGGGMMMMWWWWWWWW
WWWWWWWWWGGGGGGGGGGGGGGGGGMMMGGGGGGGGGGGGGGGGWGWWWMMMWWWWWWW
WWWWWWWWWWGWGGGGGWGWWWWWWWMWWWWWWWWWWWGWWWWWWWWWWWWWWWWWWWWW
WWWWWWWWWWWWWWWWWWWWWWWWWWWWWWWWWWWWWWWWWWWWWWWWWWWWWWWWWWWW
WWWWWWWWWWWWWWWWWWWWWWWWWWWWWWWWWWWWWWWWWWWWWWWWWWWWWWWWWWWW
WWWWWWWWWWWWWWWWWWWWWWWWWWWWWWWWWWWWWWWWWWWWWWWWWWWWWWWWWWWW
WWWWWWWWWWWWWWWWWWWWWWWWWWWWWWWWWWWWWWWWWWWWWWWWWWWWWWWWWWWW
WWWWWWWWWWWWWWWWWWWWWWWWWWWWWWWWWWWWWWWWWWWWWWWWWWWWWWWWWWWW
WWWWWWWWWWWWWWWWWWWWWWWWWWWWWWWWWWWWWWWWWWWWWWWWWWWWWWWWWWWW
WWWWWWWWWWWWWWWWWWWWWWWWWWWWWWWWWWWWWWWWWWWWWWWWWWWWWWWWWWWW
WWWWWWWWWWWWWGWWWWWWWWWWWWWWWWWWWWWWWWWWWWWWWWWWWWWWWWWWWWWW
WWWWWWWWWGWGGGGGWGWGWWGMGMMMWMMMWMWMWMWMWMWMWMWWWWWWWWWWWWWW
WWWWWWWWWGGGGGGGGGGGGGMMMDMMMDMMMMMMMMMMMMMMMMMMMMMWWWWWWWWW
WWWWWWWWGGGGGGGGGGGGGGMMMMMMMDDDDDDDMMMDMDMDMDMDDDMMWWWWWWWW
WWWWWWWWWGGGGGGGGGGMMMMMMMMMMDDDDDDDDDDDDDDDDDDDDDMMWWWWWWWW
WWWWWWWWWGGGGGGGGGGMMMMMMMMMMDDDDMDDDDDDDDDDDDDDDDMMWWWWWWWW
WWWWWWWWWGGGGGGMMMDDMMMMMDDDMDDDDMMDDDDDDDDDDDDDDMMMWWWWWWWW
WWWWWWWWWGGGGMGMMMDDMMMMMDDDDDDDDDMDDDDDDMDDDDDDDMMMWWWWWWWW
WWWWWWWWWGGMMMMMMMMMDDMMMDDDDDDDDDDDDDDDDMMDDDDDMMMWWWWWWWWW
WWWWWWWWWMMMMMMMMMMMDDMMMMMMDDDDDDDDDDDDDMMDDDDDDMMWWWWWWWWW
WWWWWWWWWMMMMMMMMMMMDDDMMDMMMMDMDDDDDDDDDDDDDDDDDMMWWWWWWWWW
WWWWWWWWMMMMMMMMMMMMMDDDMMMMMMMMMDDDDDDDDDDDDDDDDMMWWWWWWWWW
WWWWWWWWMMMMMMMMMMMMMMDDDDMMMDDDDDDDDDDDDDDDDDDDDMMWWWWWWWWW
WWWWWWWWWMMMMMMDMDDMMMMMDDDDDDDDDDDDDMDDDDDDDDDDDMMWWWWWWWWW
WWWWWWWWWMMMMMMMMMMDDDMDMMMMDDDDDDDDDMMDDDDDDDDDDDMWWWWWWWWW
WWWWWWWMMMMMMMMMMDDDDDDDDDDDDDDDDDDDDDDDDDDDDDDDDMMWWWWWWWWW
WWWWWWWWMMMMMMMMDMDDDDDDDDDDDDDDDDDDDDDDDDDDDDDDDMMWWWWWWWWW
WWWWWWWWWWDWMWMWMMMMDMMMDMMMMMMMMMMMMMMMMMMMMMMMMWWWWWWWWWWW
WWWWWWWWWWWWWWWWWWMMMWMWMWMWMWMMMWWWMWMMMMMMMMMWWWWWWWWWWWWW
WWWWWWWWWWWWWWWWWWWWWWWWWWWWWWWWWWWWWWWWWWWWWWWWWWWWWWWWWWWW
WWWWWWWWWWWWWWWWWWWWWWWWWWWWWWWWWWWWWWWWWWWWWWWWWWWWWWWWWWWW
WWWWWWWWWWWWWWWWWWWWWWWWWWWWWWWWWWWWWWWWWWWWWWWWWWWWWWWWWWWW
WWWWWWWWWWWWWWWWWWWWWWWWWWWWWWWWWWWWWWWWWWWWWWWWWWWWWWWWWWWW
